####################
#      #    ##     #
#           ##     #
#     ##           #
#     ##           #
#         #####    #
#  ####       #    #
#     #       #    #
#     #####   #    #
####          #    #
####      #####    #
#     #####        #
#            #     #
#####        #     #
#          ###     #
#  ####      #######
#  #               #
#  #               #
#                  #
####################
