####################
#           #      #
#  #####    #  #   #
#  #        #  #   #
#  #  ####  #  #   #
#  #        #  #   #
#     #     #  #   #
#     #  ####  #   #
#     #            #
#        #   #     #
#        #   ###   #
#    #####     #   #
#    #         #   #
#  ###     #####   #
#            #     #
#     ###    #     #
#  ####    #####   #
#       #          #
#      ######      #
####################
