####################
#                  #
#   ####           #
#   ####    ########
#                  #
######             #
#         #####    #
#         ###      #
####      ###      #
#     #######      #
#   ###            #
#          #########
#######            #
#        #         #
#  ###   #####     #
#  ###   #         #
#  ###   #  ####   #
#           ####   #
#                  #
####################
