###############
#             #
#    BBBBB    #
#    B        #
#    B        #
#    BBBBB    #
#             #
#    PPPP     #
#    P   P    #
#    PPPP     #
#    P        #
#    P        #
#             #
#    PPPP     #
#    P   P    #
#    PPPP     #
#    P        #
#    P        #
#             #
#             #
#      0      #
#             #
#     ___     #
#             #
               
