###############
#             #
#             #
#  BRRRRRRRG  #
#  B       G  #
#  B PPPPP G  #
#  B RRRRR G  #
#  B       G  #
#  B       G  #
#  B       G  #
#  B       G  #
#  BYYY YYYG  #
#             #
#             #
#             #
#             #
#             #
#             #
#             #
#             #
#      0      #
#             #
#     ___     #
#             #
               
