###############
#             #
#             #
#  @@@@@@@@@  #
#  @@@@@@@@@  #
#  @@@@@@@@@  #
#  @@@@@@@@@  #
#  @@@@@@@@@  #
#  @@@@@@@@@  #
#  @@@@@@@@@  #
#  @@@@@@@@@  #
#  @@@@@@@@@  #
#             #
#             #
#             #
#             #
#             #
#             #
#             #
#             #
#      0      #
#             #
#     ___     #
#             #
               
