###############
#             #
#             #
#  BBBBBBBBB  #
#  GGGGGGGGG  #
#  PPPPPPPPP  #
#  RRRRRRRRR  #
#  YYYYYYYYY  #
#  BBBBBBBBB  #
#  GGGGGGGGG  #
#  PPPPPPPPP  #
#  RRRRRRRRR  #
#             #
#             #
#             #
#             #
#             #
#             #
#             #
#             #
#      0      #
#             #
#     ___     #
#             #
               
